11111111111111111111
10000000000P00000001
10000000000000000001
10000000000000000001
10000000C00000000001
10000000000000000001
10000000000000000001
11111111000000000001
10001000011111101111
1C100001000E000000C1
11111111111111111111
