11111111111111111111
1000000000P000000001
10000000000000000001
10C00000000000000001
10000000000000000001
10000000000000000001
10000000000000000001
11111111000000000001
10001000011111110111
1C100001000E000000C1
11111111111111111111
