11111111111111
10P010101000C1
10001000010101
10101001000001
10101001111101
1C100001E00001
11111111111111
