11111111111111111111
1000000000P000000001
10000000000000000001
10000000000000000001
10000000C00000000001
10000000000000000001
10000000000000000001
11111111000000000001
10001000011111101111
1C1000010000E00000C1
11111111111111111111
