11111111111111111111111111111
100000000000000000100P0000001
100000000E0000000011111111101
10000000000000000010000000001
100C0000CCCC0CCCC010111111111
100C0C00000C0C00C010000000001
100CCCCC0CCC0C00C011111111101
10000C000C000C00C000000000001
10000C000CCC0CCCC010111110111
10000000000000000010000010111
11111111100111111111111010011
1C00000000000000001C111010011
1C000000000000000010000000011
11111111111111111111111111111
