11111111111111111111
1000P000010000000001
10000000010000E00001
11111100010000110001
10000000010000110001
10011111110000000001
10000000000000000001
10C010000000000000C1
11111111111111111111
